111111
10CE11
1PCC11
111011
1M0011
111111