11111111111111111
11100000000000111
1100C00C0CCCC0011
1000C00C0000C0001
1P00CCCC0CCCC00E1
1000000C0C0000001
11000M0C0CCCC0011
11100000000000111
11111111111111111