11111111111
1CCCCC0E011
1P0C01M1111
10CC1110111
11111111111