1111111111111111111111111111111111111111111111111111111111111111111111111111111111111111111
1000000000000000000000000000000000C0000000000000000000000000000000000000000000000000P000001
1011111111111111111111111111111111111111111111111111111111111111111111111111111111111111101
1010000000000000000000000000000000000000000000000000000000000000000000000000000000000000101
1010000000000000000000000000000000000000000000000000000000000000000000000000000000000000101
101000000000000000000000C000000000000000000000000000000000000000000000000000000000000000101
10100000000000000000000000000000000000000000000000000000000000000000000C0000000000000000101
1010000000000000000000000000000000000000000000000000000000000000000000000000000000000000101
1011111111111111111111111111111111111111111111111111111111111111111111111111111111111111101
1010000000000000000000000000000000000000000000000000000000000000000000000000000000000000101
1011111111111111111111111111111111111111111111111111111111111111111111111111111111111111101
1010000000000000000000000000000000000000000000000000000000000000000000000000000000000000101
1010000000000000000000000000000000000000000000000000000000000000000000000000000000000000101
1010000000000000000000000000000000000000000000000000000000000000000000000000000000000000101
1010000000000000000000000000000000000000000000000000000000000000000000000000000000000000101
10100000000000000000M0000000000000000000000000000000000000000000000000000000000000000000101
1010000000000C00000000000000000000000000000000000000000000000000000000000000000000000000101
10100000000000000000000000000000000000000000000000000000000000000000000000C0000000000000101
1010000000000000000000000000000000000000000000000000000000000000000000000000000000000000101
1011111111111111111111111111111111111111111111111111111111111111111111111111111111111111101
1E00000000000000000000000000000000000000000000000000000000000000000000000000000000000000001
1111111111111111111111111111111111111111111111111111111111111111111111111111111111111111111
