1111111111111
1P010000000C1
1000011111001
1P0011E000M01
1111111111111