1111111111111
100100000M0C1
100001111101
1P0011E0001
1111111111111
